NO ./pics/greystone.png
SO ./pics/bluestone.png
WE ./pics/colorstone.png
EA ./pics/mossy.png


F 22,140,72
C 66,135,245



1111111111111111111111111
1000000000110000000000001
1011000001110000000000001
100100000000000000000000111111111
111111111011000001110000000000001
100000000011000001110111101111111
11110111111111011100000010001
11110111111111011101010010001
11000000110101011100000010001
10000000000000001100000010001
10000000000000001101010010001
11000001110101011111011110N01
11110111111010110111101000111
11111111111111111111111111111
