NO ./pics/greystone.png
SO ./pics/bluestone.png
WE ./pics/colorstone.png
EA ./pics/mossy.png


F 22,140,72
C 66,135,245



111111111111
100000000011
101100000111
10010000W001
111111111111


