NO ./pics/wall_grey1024.png
SO ./pics/wall_blue1024.png
WE ./pics/wall_wood1024.png
EA ./pics/wall_moss1024.png
F 22,140,72
C 66,135,245
111111111111111111111111
100000000000000000000011
001100000111101100000111
100100000001100100000001
111111101111111111101111
111111101111111111101111
100000000000001000000011
101100000111111100000111
100100000001100100000E01
111111111111111111111111