NO ./pics/wall_grey1024.png
SO ./pics/wall_blue1024.png
WE ./pics/wall_wood1024.png
EA ./pics/wall_moss1024.png


F 22,140,72
C 66,135,245




 111111111111
1N01
 11

 

