NO ./pics/trees2.png
SO ./pics/trees2.png
WE ./pics/trees2.png
EA ./pics/trees2.png
F 41,87,84
C 41,87,84
111111111111111111111111
100000000000000000000011
101100000111101100000111
100100000001100100000001
101111101111111111101101
101111101111111111101101
100000000000000000000001
101100000111111100000101
100000000000000000000E01
111111111111111111111111